,nonVotants,pours,contres,abstentions,total_count
LFI,0,0,17,0,17
LT,0,0,16,0,16
NI,0,2,12,1,15
UDI,0,3,12,1,16
LR,0,0,89,0,89
MODEM,0,52,0,0,52
GDR,0,1,13,0,14
AE,0,18,0,0,18
SOC,0,0,24,0,24
LREM,1,239,0,1,241
