,nonVotants,pours,contres,abstentions,total_count
LFI,0,2,0,0,2
LT,0,0,0,0,0
NI,0,2,0,0,2
UDI,0,0,1,0,1
LR,0,1,8,0,9
MODEM,0,2,6,0,8
GDR,0,1,0,0,1
AE,0,3,2,0,5
SOC,0,0,0,2,2
LREM,1,13,32,3,49
