,nonVotants,pours,contres,abstentions,total_count
LFI,0,0,17,0,17
LT,0,3,12,1,16
NI,0,7,14,2,23
UDI,0,7,5,2,14
LR,0,57,20,9,86
MODEM,0,37,9,4,50
GDR,0,0,15,0,15
AE,0,13,5,1,19
SOC,0,2,22,0,24
LREM,1,171,30,34,236
