,nonVotants,pours,contres,abstentions,total_count
LFI,0,2,0,0,2
LT,0,4,2,0,6
NI,0,3,3,0,6
UDI,0,0,2,0,2
LR,0,11,0,0,11
MODEM,0,0,12,0,12
GDR,0,2,0,0,2
AE,0,1,3,0,4
SOC,0,4,0,0,4
LREM,1,5,50,0,56
