,nonVotants,pours,contres,abstentions,total_count
LFI,0,0,0,0,0
LT,0,5,3,0,8
NI,0,0,0,1,1
UDI,0,0,0,0,0
LR,0,1,7,0,8
MODEM,0,2,2,0,4
GDR,0,0,0,0,0
AE,0,1,1,0,2
SOC,0,0,3,0,3
LREM,2,3,32,1,38
