,nonVotants,pours,contres,abstentions,total_count
LFI,0,0,17,0,17
LT,0,1,1,14,16
NI,0,8,10,4,22
UDI,0,8,1,7,16
LR,0,0,89,2,91
MODEM,0,51,0,3,54
GDR,0,0,14,1,15
AE,0,19,0,1,20
SOC,0,0,23,1,24
LREM,1,258,0,1,260
