,nonVotants,pours,contres,abstentions,total_count
LFI,0,0,6,0,6
LT,0,1,2,0,3
NI,0,2,2,0,4
UDI,0,1,0,0,1
LR,0,6,0,2,8
MODEM,0,8,0,0,8
GDR,0,0,2,0,2
AE,0,3,0,0,3
SOC,0,0,5,0,5
LREM,2,45,1,0,48
