,nonVotants,pours,contres,abstentions,total_count
LFI,0,4,0,0,4
LT,0,1,1,0,2
NI,0,11,0,0,11
UDI,0,0,0,1,1
LR,0,1,9,0,10
MODEM,0,0,11,4,15
GDR,0,3,0,0,3
AE,0,1,3,0,4
SOC,0,5,1,0,6
LREM,2,5,55,1,63
