,nonVotants,pours,contres,abstentions,total_count
LFI,0,0,5,0,5
LT,0,4,0,0,4
NI,0,7,0,2,9
UDI,0,2,0,0,2
LR,0,1,0,43,44
MODEM,0,14,0,0,14
GDR,0,0,4,0,4
AE,0,7,0,0,7
SOC,0,0,0,7,7
LREM,1,105,0,0,106
