,nonVotants,pours,contres,abstentions,total_count
LFI,0,5,0,0,5
LT,0,3,0,1,4
NI,0,3,0,0,3
UDI,0,0,1,0,1
LR,0,1,7,1,9
MODEM,0,0,11,0,11
GDR,0,4,0,0,4
AE,0,0,3,0,3
SOC,0,7,0,0,7
LREM,2,0,51,0,53
