,nonVotants,pours,contres,abstentions,total_count
LFI,0,6,0,0,6
LT,0,0,0,0,0
NI,0,4,4,1,9
UDI,0,0,3,0,3
LR,0,0,5,13,18
MODEM,0,0,24,0,24
GDR,0,7,0,0,7
AE,0,0,8,0,8
SOC,0,7,0,0,7
LREM,1,0,132,0,133
