,nonVotants,pours,contres,abstentions,total_count
LFI,0,0,2,1,3
LT,0,7,1,0,8
NI,0,1,4,0,5
UDI,0,1,4,0,5
LR,0,38,0,0,38
MODEM,0,1,13,0,14
GDR,0,0,0,4,4
AE,0,0,3,0,3
SOC,0,8,0,0,8
LREM,1,1,79,1,82
