,nonVotants,pours,contres,abstentions,total_count
LFI,0,0,4,0,4
LT,0,1,1,0,2
NI,0,1,1,0,2
UDI,0,0,0,0,0
LR,1,0,5,0,6
MODEM,0,3,0,0,3
GDR,0,0,3,0,3
AE,0,0,0,2,2
SOC,0,0,3,0,3
LREM,1,23,2,0,26
