,nonVotants,pours,contres,abstentions,total_count
LFI,0,5,0,0,5
LT,0,0,4,0,4
NI,0,0,8,0,8
UDI,0,0,0,0,0
LR,0,0,12,0,12
MODEM,0,0,11,1,12
GDR,0,5,0,0,5
AE,0,1,1,0,2
SOC,0,0,0,12,12
LREM,2,0,61,1,64
