,nonVotants,pours,contres,abstentions,total_count
LFI,0,0,3,0,3
LT,0,0,4,0,4
NI,0,4,5,1,10
UDI,0,0,1,0,1
LR,0,6,5,9,20
MODEM,0,0,9,1,10
GDR,0,0,4,0,4
AE,0,0,7,0,7
SOC,0,0,3,0,3
LREM,2,0,83,0,85
