,nonVotants,pours,contres,abstentions,total_count
LFI,0,3,0,0,3
LT,0,1,1,0,2
NI,0,1,1,0,2
UDI,0,0,2,0,2
LR,0,1,6,0,7
MODEM,0,0,6,0,6
GDR,0,0,0,0,0
AE,0,0,4,0,4
SOC,0,0,1,0,1
LREM,1,3,35,1,40
