,nonVotants,pours,contres,abstentions,total_count
LFI,0,0,0,3,3
LT,0,1,2,0,3
NI,0,0,3,0,3
UDI,0,0,4,0,4
LR,0,0,2,1,3
MODEM,0,0,6,0,6
GDR,0,2,0,0,2
AE,0,0,0,1,1
SOC,0,3,0,0,3
LREM,1,0,21,0,22
