,nonVotants,pours,contres,abstentions,total_count
LFI,0,0,6,0,6
LT,0,2,1,1,4
NI,0,1,5,0,6
UDI,0,1,0,0,1
LR,1,26,0,0,27
MODEM,0,8,3,1,12
GDR,0,2,0,0,2
AE,0,1,1,0,2
SOC,0,2,0,0,2
LREM,1,3,65,7,76
