,nonVotants,pours,contres,abstentions,total_count
LFI,0,0,5,0,5
LT,0,1,0,0,1
NI,0,1,1,0,2
UDI,0,0,2,0,2
LR,0,0,20,0,20
MODEM,0,2,2,0,4
GDR,0,0,0,0,0
AE,0,1,1,0,2
SOC,0,0,3,0,3
LREM,2,47,0,0,49
