,nonVotants,pours,contres,abstentions,total_count
LFI,0,3,0,0,3
LT,0,0,1,0,1
NI,0,0,3,1,4
UDI,0,1,1,1,3
LR,0,16,1,0,17
MODEM,0,0,6,1,7
GDR,0,4,0,0,4
AE,0,0,2,1,3
SOC,0,4,0,0,4
LREM,2,0,52,0,54
